10.oxcccc
....o.....
..........
o.....o...
...o......
..........
........oo
..........
....o....o
..........
..........
