10
..........
.....oo..o
..o..oo...
..........
.......o..
...oo....o
o.........
........o.
.oo.......
..........
